....................
....................
....................
..ba.ab.a..a.b..b..b
a..a.a.b.baa.ba.b.a.
....................
....................
....................
....................
....................
....................
....................
....................
....................
....................
....................
....................