..............................
..............................
..............................
2.............................
2.............................
2..............................
2......222222......22222222222
2......2....2......2..........
22222222....2......2..........
............2......2..........
............2......2..........
............2......22222222222
2222222222222................2
2............................2
2............................2
2............................2
2..222....22222222222222222222
2..222...22...................
2..22....2....................
2..22....22...................
2..22.....2222222222..........
2..22..............2222222222.
2..22.......................22
2..222.......................2
2...2222222..................2
2....222222..................2
2............................2
2............................2
2............22222222222222222
22222222222222................
..............................
